Advances in Colloid and Interface Science = Adv. Colloid Interface Sci.
Advanced Materials = Adv. Mater.
Aerosol Science and Technology = Aerosol Sci. Technol.
AIChE Journal = AIChE J.
Annals of Physics = Ann. Phys.
Annalen der Physik = Ann. Physik
Annual Review of Chemical and Biomolecular Engineering = Annu. Rev. Chem. Biomol. Eng.
Annual Review of Condensed Matter Physics = Annu. Rev. Condens. Matter Phys.
Annual Review of Fluid Mechanics = Annu. Rev. Fluid Mech.
Annual Review of Physical Chemistry = Annu. Rev. Phys. Chem. 
Astrophysics Journal = Astrophys J.
Applied Optics = Appl. Opt.
Applied Physics Letters = Appl. Phys. Lett.
Applied Scientific Research = Appl. Sci. Res.
Biochemical Engineering Journal = Biochem. Eng. J.
Biophysical Journal = Biophys. J.
Biotechnology Progress = Biotechnol. Progr.
British Journal of Applied Physics = Br. J. Appl. Phys.
Bulletin of The American Physical Society = Bull. Am. Phys. Soc.
Canadian Journal of Physics = Can. J. Phys.
Chemical Engineering Science = Chem. Eng. Sci.
Cement and Concrete Research = Cem. Concr. Res.
Chaos: An Interdisciplinary Journal of Nonlinear Science = Chaos
Chemical Engineering Research and Design = Chem. Eng. Res. Des.
Chemical Engineering and Processing = Chem. Eng. Process.
Chemical Engineering Science = Chem. Eng. Sci.
Colloid and Polymer Science = Colloid Polym. Sci.
Colloids and Surfaces = Colloids Surf.
Colloids and Surfaces A = Colloids Surf., A
Colloids and Surfaces A: Physicochemical and Engineering Aspects = Colloids Surf., A
Computers \& Fluids = Comput. Fluids
Comptes Rendus Mecanique = C. R. Mecanique
Contemporary Physics = Contemp. Phys.
Current Opinion in Colloid \& Interface Science = Curr. Opin. Colloid Interface Sci.
Die Angewandte Makromolekulare Chemie = Angew. Makromol. Chem.
Europhysics Letters (EPL) = Europhys. Lett.
EPL (Europhysics Letters) = Europhys. Lett.
Faraday Discussions = Farad. Discuss.
Granular Matter = Granul. Matter
Image and Vision Computing = Image Vision Comput.
International Journal of Heat and Mass Transfer = Int. J. Heat Mass Transfer
International Journal of Modern Physics B = Int. J. Mod. Phys. B
International Journal of Modern Physics C = Int. J. Mod. Phys. C
International Journal of Multiphase Flow = Int. J. Multiphase Flow
International Journal for Numerical Methods in Engineering = Int. J. Numer. Meth. Engng
International Journal of Plasticity = Int. J. Plasticity
International Journal of Solids and Structures = Int. J. Solids Struct.
Japanese Journal of Multiphase Flow = Japanese J. Multiphase Flow
JAPANESE JOURNAL OF MULTIPHASE FLOW = Japanese J. Multiphase Flow
Journal of Applied Physics = J. Appl. Phys.
Journal of the American Ceramic Society = J. Am. Ceram. Soc.
Journal of Physics D: Applied Physics = J. Phys. D: Appl. Phys.
Journal of physical chemistry letters = J. Phys. Chem. Lett.
The journal of physical chemistry letters = J. Phys. Chem. Lett.
Journal of Chemical Education = J. Chem. Educ.
Journal of Colloid and Interface Science = J. Colloid Interface Sci.
Journal of Computational Physics = J. Comput. Phys.
Journal of Dispersion Science and Technology = J. Dispersion Sci. Technol.
Journal of the European Ceramic Society = J. Eur. Ceram. Soc.
Journal of Fluid Mechanics = J. Fluid Mech.
Journal of Membrane Science = J. Membr. Sci.
Journal of Magnetism and Magnetic Materials = J. Magn. Magn. Mater.
Journal of Non-Newtonian Fluid Mechanics = J. Non-Newtonian Fluid Mech.
Journal of Physics: Condensed Matter = J. Phys.: Condens. Matter
Journal de Physique II = J. Phys. II
Journal of Polymer Science Part B: Polymer Physics = J. Polym. Sci. Pol. Phys.
Journal of Quantitative Spectroscopy \& Radiative Transfer = J. Quant. Spectrosc \& Radiat. Transfer
Journal of Rheology = J. Rheol.
Journal of Rheology (1978-present) = J. Rheol.
Journal of Statistical Mechanics: Theory and Experiment = J. Stat. Mech.
Journal of Statistical Physics = J. Stat. Phys.
Korea-Australia Rheology Journal = Korea-Aust. Rheol. J.
Langmuir : the ACS journal of surfaces and colloids = Langmuir
Mechanics of Materials = Mech. Mater.
Modern Physics Letters A = Mod. Phys. Lett. A
Modern Physics Letters B = Mod. Phys. Lett. B
Nature materials = Nat. Mater.
Nature Nature Communications = Nat. Commun.
NPG Asia Materials = NPG Asia Mater.
Oil \& Gas Science and Technology -- Rev. IFP = Oil Gas Sci. Technol.
Particle \& Particle Systems Characterization = Part. Part. Syst. Charact.
Philosophical Transactions of the Royal Society of London. Series A: Mathematical, Physical and Engineering Sciences = Phil. Trans. R. Soc. Lond. A
Philosophical Transactions of the Royal Society A: Mathematical, Physical and Engineering Sciences = Phil. Trans. R. Soc. Lond. A
Physica A: Statistical Mechanics and its Applications = Phys. A
Physical Chemistry Chemical Physics = Phys. Chem. Chem. Phys.
Physics of Fluids A: Fluid Dy„ÅÇ) = Phys. Fluids A
Physics of Fluids (1994-present) = Phys. Fluids
Physical Review Letter = Phys. Rev. Lett.
Physical Review B = Phys. Rev. B
Physical Review E = Phys. Rev. E
Physical review. E, Statistical physics, plasmas, fluids, and related interdisciplinary topics = Phys. Rev. E
Physics Reports = Phys. Rep.
Progress of Theoretical and Experimental Physics = Prog. Theor. Exp. Phys.
Progress of Theoretical Physics = Prog. Theor. Phys.
Progress of Theoretical Physics Supplement = Prog. Theor. Phys. Supp.
Proceedings of the National Academy of Sciences = Proc. Natl. Acad. Sci. USA
Proceedings of the National Academy of Sciences of the United States of America = Proc. Natl. Acad. Sci. USA
Proceedings of the Royal Society A: Mathematical, Physical and Engineering Sciences = Proc. R. Soc. A
Proceedings of the Royal Society of London A: Mathematical, Physical and Engineering Sciences = Proc. R. Soc. Lond. A
Proceedings of the Royal Society of London. Series A, Containing Papers of a Mathematical and Physical Character = Proc. R. Soc. Lond. A
Reports on Progress in Physics = Rep. Prog. Phys.
Rheologica Acta = Rheol. Acta
Scientific Reports = Sci. Rep.
Smart Materials and Structures = Smart Mater. Struct.
The European Physical Journal Applied Physics = Eur. Phys. J. Appl. Phys.
The European Physical Journal E = Eur. Phys. J. E
The European Physical Journal B = Eur. Phys. J. B
The European Physical Journal Special Topics = Eur. Phys. J. Special Topics
The Journal of Chemical Physics = J. Chem. Phys.
The Journal of Physical Chemistry = J. Phys. Chem.
The Journal of Physical Chemistry B = J. Phys. Chem. B
The Quarterly Journal of Mechanics and Applied Mathematics = Q. J. Mech. Appl. Math.
Theoretical and Computational Fluid Dynamics = Theor. Comp. Fluid. Dyn.
Transactions of The Society of Rheology (1957-1977) = Trans. Soc. Rheol.
Wiley Interdisciplinary Reviews: Nanomedicine and Nanobiotechnology = Wiley Interdiscip. Rev. Nanomed. Nanobiotechnol.
